1999831045 0 2 4 19780 -1 -1 -1 -1 -1 0 -1 -1 0 211710 -1 163767 87020 50535 -1 1 -1 0 -1 63 96 96 117.455238 116.414528 -19.801666 123.071587 123.585487 55.198349 117.455238 116.414528 3.579506 123.071587 123.585487 78.579521 4005 0 0 0 0 2021196069 1884 0.000000 0.000000 0.000000 1.000000 480.000000 960.000000 0.000000 -1 -1
2021196069 1884 0.000000 0.000000 0.000000 1.000000 480.000000 960.000000 0.000000 1999831045 4
1999831045 0 2 3 19780 -1 -1 -1 -1 -1 0 -1 -1 0 211710 -1 163767 87020 50535 -1 2 -1 0 -1 63 96 96 120.802849 120.764854 -11.300869 120.802849 120.764854 63.699146 120.802849 120.764854 3.579567 120.802849 120.764854 78.579582 1576 0 0 0 0 2021261606 32982 0.000000 0.000000 0.000000 1.000000 480.000000 720.000000 0.000000 -1 -1
2021261606 32982 0.000000 0.000000 0.000000 1.000000 480.000000 720.000000 0.000000 1999831045 4
1999831045 0 2 2 19780 -1 -1 -1 -1 -1 0 -1 -1 0 211710 -1 163767 87020 50535 -1 15 -1 0 -1 63 96 96 120.000008 120.000008 -33.639690 120.000008 120.000008 41.360325 120.000008 120.000008 -33.639690 120.000008 120.000008 41.360325 0 0 0 0 6 2022113587 32936 0.000000 0.000000 0.000000 1.000000 480.000000 480.000000 0.000000 -1 -1
2022113587 32936 0.000000 0.000000 0.000000 1.000000 480.000000 480.000000 0.000000 1999831045 4
1999831045 0 0 3 19780 -1 -1 -1 -1 -1 0 -1 -1 0 211710 -1 163767 87020 50535 -1 13 -1 0 -1 63 96 96 120.000008 120.000008 -33.639690 120.000008 120.000008 41.360325 120.000008 120.000008 -33.639690 120.000008 120.000008 41.360325 0 0 0 0 6 2021982513 32936 0.000000 0.000000 0.000000 1.000000 0.000000 720.000000 0.000000 -1 -1
2021982513 32936 0.000000 0.000000 0.000000 1.000000 0.000000 720.000000 0.000000 1999831045 4
1999831045 0 1 2 19780 -1 -1 -1 -1 -1 0 -1 -1 0 211710 -1 163767 87020 50535 -1 16 -1 0 -1 63 96 96 120.000008 120.000008 -33.639690 120.000008 120.000008 41.360325 120.000008 120.000008 -33.639690 120.000008 120.000008 41.360325 0 0 0 0 6 2022179124 32936 0.000000 0.000000 0.000000 1.000000 240.000000 480.000000 0.000000 -1 -1
2022179124 32936 0.000000 0.000000 0.000000 1.000000 240.000000 480.000000 0.000000 1999831045 4
1999831045 0 0 3 19780 -1 -1 -1 -1 -1 0 -1 -1 0 211710 -1 163767 87020 50535 -1 13 -1 0 -1 63 96 96 120.000008 120.000008 -33.639690 120.000008 120.000008 41.360325 120.000008 120.000008 -33.639690 120.000008 120.000008 41.360325 0 0 0 0 6 2021982513 32936 0.000000 0.000000 0.000000 1.000000 0.000000 720.000000 0.000000 -1 -1
2021982513 32936 0.000000 0.000000 0.000000 1.000000 0.000000 720.000000 0.000000 1999831045 4
1999831045 0 1 2 19780 -1 -1 -1 -1 -1 0 -1 -1 0 211710 -1 163767 87020 50535 -1 16 -1 0 -1 63 96 96 120.000008 120.000008 -33.639690 120.000008 120.000008 41.360325 120.000008 120.000008 -33.639690 120.000008 120.000008 41.360325 0 0 0 0 6 2022179124 32936 0.000000 0.000000 0.000000 1.000000 240.000000 480.000000 0.000000 -1 -1
2022179124 32936 0.000000 0.000000 0.000000 1.000000 240.000000 480.000000 0.000000 1999831045 4
1999831045 0 2 2 19780 -1 -1 -1 -1 -1 0 -1 -1 0 211710 -1 163767 87020 50535 -1 15 -1 0 -1 63 96 96 120.000008 120.000008 -33.639690 120.000008 120.000008 41.360325 120.000008 120.000008 -33.639690 120.000008 120.000008 41.360325 0 0 0 0 6 2022113587 32936 0.000000 0.000000 0.000000 1.000000 480.000000 480.000000 0.000000 -1 -1
2022113587 32936 0.000000 0.000000 0.000000 1.000000 480.000000 480.000000 0.000000 1999831045 4
1999831045 0 0 3 19780 -1 -1 -1 -1 -1 0 -1 -1 0 211710 -1 163767 87020 50535 -1 13 -1 0 -1 63 96 96 120.000008 120.000008 -33.639690 120.000008 120.000008 41.360325 120.000008 120.000008 -33.639690 120.000008 120.000008 41.360325 0 0 0 0 6 2021982513 32936 0.000000 0.000000 0.000000 1.000000 0.000000 720.000000 0.000000 -1 -1
2021982513 32936 0.000000 0.000000 0.000000 1.000000 0.000000 720.000000 0.000000 1999831045 4
1999831045 0 1 2 19780 -1 -1 -1 -1 -1 0 -1 -1 0 211710 -1 163767 87020 50535 -1 16 -1 0 -1 63 96 96 120.000008 120.000008 -33.639690 120.000008 120.000008 41.360325 120.000008 120.000008 -33.639690 120.000008 120.000008 41.360325 0 0 0 0 6 2022179124 32936 0.000000 0.000000 0.000000 1.000000 240.000000 480.000000 0.000000 -1 -1
2022179124 32936 0.000000 0.000000 0.000000 1.000000 240.000000 480.000000 0.000000 1999831045 4
1999831045 0 0 3 19780 -1 -1 -1 -1 -1 0 -1 -1 0 211710 -1 163767 87020 50535 -1 13 -1 0 -1 63 96 96 120.000008 120.000008 -33.639690 120.000008 120.000008 41.360325 120.000008 120.000008 -33.639690 120.000008 120.000008 41.360325 0 0 0 0 6 2021982513 32936 0.000000 0.000000 0.000000 1.000000 0.000000 720.000000 0.000000 -1 -1
2021982513 32936 0.000000 0.000000 0.000000 1.000000 0.000000 720.000000 0.000000 1999831045 4
1999831045 0 1 2 19780 -1 -1 -1 -1 -1 0 -1 -1 0 211710 -1 163767 87020 50535 -1 16 -1 0 -1 63 96 96 120.000008 120.000008 -33.639690 120.000008 120.000008 41.360325 120.000008 120.000008 -33.639690 120.000008 120.000008 41.360325 0 0 0 0 6 2022179124 32936 0.000000 0.000000 0.000000 1.000000 240.000000 480.000000 0.000000 -1 -1
2022179124 32936 0.000000 0.000000 0.000000 1.000000 240.000000 480.000000 0.000000 1999831045 4
1999831045 0 2 1 19780 -1 -1 -1 -1 -1 0 -1 -1 0 211710 -1 163767 87020 50535 -1 24 -1 0 -1 63 96 96 120.000008 120.000008 -33.639690 120.000008 120.000008 41.360325 120.000008 120.000008 -33.639690 120.000008 120.000008 41.360325 0 0 0 0 6 2022703420 32936 0.000000 0.000000 0.000000 1.000000 480.000000 240.000000 0.000000 -1 -1
2022703420 32936 0.000000 0.000000 0.000000 1.000000 480.000000 240.000000 0.000000 1999831045 4
1999831045 0 0 4 19780 -1 -1 -1 -1 -1 0 -1 -1 0 211710 -1 163767 87020 50535 -1 8 -1 0 -1 63 96 96 120.000008 120.000008 -33.639690 120.000008 120.000008 41.360325 120.000008 120.000008 -33.639690 120.000008 120.000008 41.360325 0 0 0 0 6 2021654828 32936 0.000000 0.000000 0.000000 1.000000 0.000000 960.000000 0.000000 -1 -1
2021654828 32936 0.000000 0.000000 0.000000 1.000000 0.000000 960.000000 0.000000 1999831045 4
1999831045 0 0 3 19780 -1 -1 -1 -1 -1 0 -1 -1 0 211710 -1 163767 87020 50535 -1 13 -1 0 -1 63 96 96 120.000008 120.000008 -33.639690 120.000008 120.000008 41.360325 120.000008 120.000008 -33.639690 120.000008 120.000008 41.360325 0 0 0 0 6 2021982513 32936 0.000000 0.000000 0.000000 1.000000 0.000000 720.000000 0.000000 -1 -1
2021982513 32936 0.000000 0.000000 0.000000 1.000000 0.000000 720.000000 0.000000 1999831045 4
1999831045 0 1 2 19780 -1 -1 -1 -1 -1 0 -1 -1 0 211710 -1 163767 87020 50535 -1 16 -1 0 -1 63 96 96 120.000008 120.000008 -33.639690 120.000008 120.000008 41.360325 120.000008 120.000008 -33.639690 120.000008 120.000008 41.360325 0 0 0 0 6 2022179124 32936 0.000000 0.000000 0.000000 1.000000 240.000000 480.000000 0.000000 -1 -1
2022179124 32936 0.000000 0.000000 0.000000 1.000000 240.000000 480.000000 0.000000 1999831045 4
1999831045 0 2 1 19780 -1 -1 -1 -1 -1 0 -1 -1 0 211710 -1 163767 87020 50535 -1 24 -1 0 -1 63 96 96 120.000008 120.000008 -33.639690 120.000008 120.000008 41.360325 120.000008 120.000008 -33.639690 120.000008 120.000008 41.360325 0 0 0 0 6 2022703420 32936 0.000000 0.000000 0.000000 1.000000 480.000000 240.000000 0.000000 -1 -1
2022703420 32936 0.000000 0.000000 0.000000 1.000000 480.000000 240.000000 0.000000 1999831045 4
1999831045 0 3 3 19780 -1 -1 -1 -1 -1 0 -1 -1 0 211710 -1 163767 87020 50535 -1 3 -1 0 -1 63 96 96 118.400391 119.928749 -17.943604 121.599625 121.600960 57.196518 118.400391 119.844704 3.607582 121.599625 121.685005 78.747704 3620 0 0 0 0 2021327143 32951 0.000000 0.000000 0.000000 1.000000 720.000000 720.000000 0.000000 -1 -1
2021327143 32951 0.000000 0.000000 0.000000 1.000000 720.000000 720.000000 0.000000 1999831045 4
1999831045 0 3 2 19780 -1 -1 -1 -1 -1 0 -1 -1 0 211710 -1 163767 87020 50535 -1 6 -1 0 -1 63 96 96 120.000008 117.907112 -12.193336 120.000008 123.622597 62.812653 120.000008 117.907112 3.576462 120.000008 123.622597 78.582458 2057 0 0 0 0 2021523754 32939 0.000000 0.000000 0.000000 1.000000 720.000000 480.000000 0.000000 -1 -1
2021523754 32939 0.000000 0.000000 0.000000 1.000000 720.000000 480.000000 0.000000 1999831045 4
1999831045 0 3 4 19780 -1 -1 -1 -1 -1 0 -1 -1 0 211710 -1 163767 87020 50535 -1 4 -1 0 -1 63 96 96 117.455238 116.414528 -19.801666 123.071587 123.585487 55.198349 117.455238 116.414528 3.579506 123.071587 123.585487 78.579521 4005 0 0 0 0 2021392680 1884 0.000000 0.000000 0.000000 1.000000 720.000000 960.000000 0.000000 -1 -1
2021392680 1884 0.000000 0.000000 0.000000 1.000000 720.000000 960.000000 0.000000 1999831045 4
1999831045 0 0 3 19780 -1 -1 -1 -1 -1 0 -1 -1 0 211710 -1 163767 87020 50535 -1 13 -1 0 -1 63 96 96 120.000008 120.000008 -33.639690 120.000008 120.000008 41.360325 120.000008 120.000008 -33.639690 120.000008 120.000008 41.360325 0 0 0 0 6 2021982513 32936 0.000000 0.000000 0.000000 1.000000 0.000000 720.000000 0.000000 -1 -1
2021982513 32936 0.000000 0.000000 0.000000 1.000000 0.000000 720.000000 0.000000 1999831045 4
1999831045 0 1 2 19780 -1 -1 -1 -1 -1 0 -1 -1 0 211710 -1 163767 87020 50535 -1 16 -1 0 -1 63 96 96 120.000008 120.000008 -33.639690 120.000008 120.000008 41.360325 120.000008 120.000008 -33.639690 120.000008 120.000008 41.360325 0 0 0 0 6 2022179124 32936 0.000000 0.000000 0.000000 1.000000 240.000000 480.000000 0.000000 -1 -1
2022179124 32936 0.000000 0.000000 0.000000 1.000000 240.000000 480.000000 0.000000 1999831045 4
1999831045 0 2 1 19780 -1 -1 -1 -1 -1 0 -1 -1 0 211710 -1 163767 87020 50535 -1 24 -1 0 -1 63 96 96 120.000008 120.000008 -33.639690 120.000008 120.000008 41.360325 120.000008 120.000008 -33.639690 120.000008 120.000008 41.360325 0 0 0 0 6 2022703420 32936 0.000000 0.000000 0.000000 1.000000 480.000000 240.000000 0.000000 -1 -1
2022703420 32936 0.000000 0.000000 0.000000 1.000000 480.000000 240.000000 0.000000 1999831045 4
1999831045 0 0 3 19780 -1 -1 -1 -1 -1 0 -1 -1 0 211710 -1 163767 87020 50535 -1 13 -1 0 -1 63 96 96 120.000008 120.000008 -33.639690 120.000008 120.000008 41.360325 120.000008 120.000008 -33.639690 120.000008 120.000008 41.360325 0 0 0 0 6 2021982513 32936 0.000000 0.000000 0.000000 1.000000 0.000000 720.000000 0.000000 -1 -1
2021982513 32936 0.000000 0.000000 0.000000 1.000000 0.000000 720.000000 0.000000 1999831045 4
1999831045 0 1 2 19780 -1 -1 -1 -1 -1 0 -1 -1 0 211710 -1 163767 87020 50535 -1 16 -1 0 -1 63 96 96 120.000008 120.000008 -33.639690 120.000008 120.000008 41.360325 120.000008 120.000008 -33.639690 120.000008 120.000008 41.360325 0 0 0 0 6 2022179124 32936 0.000000 0.000000 0.000000 1.000000 240.000000 480.000000 0.000000 -1 -1
2022179124 32936 0.000000 0.000000 0.000000 1.000000 240.000000 480.000000 0.000000 1999831045 4
1999831045 0 2 1 19780 -1 -1 -1 -1 -1 0 -1 -1 0 211710 -1 163767 87020 50535 -1 24 -1 0 -1 63 96 96 120.000008 120.000008 -33.639690 120.000008 120.000008 41.360325 120.000008 120.000008 -33.639690 120.000008 120.000008 41.360325 0 0 0 0 6 2022703420 32936 0.000000 0.000000 0.000000 1.000000 480.000000 240.000000 0.000000 -1 -1
2022703420 32936 0.000000 0.000000 0.000000 1.000000 480.000000 240.000000 0.000000 1999831045 4
1999831045 0 3 0 19780 -1 -1 -1 -1 -1 0 -1 -1 0 211710 -1 163767 87020 50535 -1 26 -1 0 -1 63 96 96 120.000008 120.000008 -33.639690 120.000008 120.000008 41.360325 120.000008 120.000008 -33.639690 120.000008 120.000008 41.360325 0 0 0 0 6 2022834494 32936 0.000000 0.000000 0.000000 1.000000 720.000000 0.000000 0.000000 -1 -1
2022834494 32936 0.000000 0.000000 0.000000 1.000000 720.000000 0.000000 0.000000 1999831045 4
1999831045 0 2 3 19780 -1 -1 -1 -1 -1 0 -1 -1 0 211710 -1 163767 87020 50535 -1 2 -1 0 -1 63 96 96 120.802849 120.764854 -11.300869 120.802849 120.764854 63.699146 120.802849 120.764854 3.579567 120.802849 120.764854 78.579582 1576 0 0 0 0 2021261606 32982 0.000000 0.000000 0.000000 1.000000 480.000000 720.000000 0.000000 -1 -1
2021261606 32982 0.000000 0.000000 0.000000 1.000000 480.000000 720.000000 0.000000 1999831045 4
1999831045 0 3 3 19780 -1 -1 -1 -1 -1 0 -1 -1 0 211710 -1 163767 87020 50535 -1 3 -1 0 -1 63 96 96 118.400391 119.928749 -17.943604 121.599625 121.600960 57.196518 118.400391 119.844704 3.607582 121.599625 121.685005 78.747704 3620 0 0 0 0 2021327143 32951 0.000000 0.000000 0.000000 1.000000 720.000000 720.000000 0.000000 -1 -1
2021327143 32951 0.000000 0.000000 0.000000 1.000000 720.000000 720.000000 0.000000 1999831045 4
1999831045 0 2 0 19780 -1 -1 -1 -1 -1 0 -1 -1 0 211710 -1 163767 87020 50535 -1 27 -1 0 -1 63 96 96 120.000008 120.000008 -33.639690 120.000008 120.000008 41.360325 120.000008 120.000008 -33.639690 120.000008 120.000008 41.360325 0 0 0 0 6 2022900031 32936 0.000000 0.000000 0.000000 1.000000 480.000000 0.000000 0.000000 -1 -1
2022900031 32936 0.000000 0.000000 0.000000 1.000000 480.000000 0.000000 0.000000 1999831045 4
1999831045 0 3 2 19780 -1 -1 -1 -1 -1 0 -1 -1 0 211710 -1 163767 87020 50535 -1 6 -1 0 -1 63 96 96 120.000008 117.907112 -12.193336 120.000008 123.622597 62.812653 120.000008 117.907112 3.576462 120.000008 123.622597 78.582458 2057 0 0 0 0 2021523754 32939 0.000000 0.000000 0.000000 1.000000 720.000000 480.000000 0.000000 -1 -1
2021523754 32939 0.000000 0.000000 0.000000 1.000000 720.000000 480.000000 0.000000 1999831045 4
1999831045 0 2 2 19780 -1 -1 -1 -1 -1 0 -1 -1 0 211710 -1 163767 87020 50535 -1 15 -1 0 -1 63 96 96 120.000008 120.000008 -33.639690 120.000008 120.000008 41.360325 120.000008 120.000008 -33.639690 120.000008 120.000008 41.360325 0 0 0 0 6 2022113587 32936 0.000000 0.000000 0.000000 1.000000 480.000000 480.000000 0.000000 -1 -1
2022113587 32936 0.000000 0.000000 0.000000 1.000000 480.000000 480.000000 0.000000 1999831045 4
1999831045 0 3 2 19780 -1 -1 -1 -1 -1 0 -1 -1 0 211710 -1 163767 87020 50535 -1 6 -1 0 -1 63 96 96 120.000008 117.907112 -12.193336 120.000008 123.622597 62.812653 120.000008 117.907112 3.576462 120.000008 123.622597 78.582458 2057 0 0 0 0 2021523754 32939 0.000000 0.000000 0.000000 1.000000 720.000000 480.000000 0.000000 -1 -1
2021523754 32939 0.000000 0.000000 0.000000 1.000000 720.000000 480.000000 0.000000 1999831045 4
1999831045 0 2 2 19780 -1 -1 -1 -1 -1 0 -1 -1 0 211710 -1 163767 87020 50535 -1 15 -1 0 -1 63 96 96 120.000008 120.000008 -33.639690 120.000008 120.000008 41.360325 120.000008 120.000008 -33.639690 120.000008 120.000008 41.360325 0 0 0 0 6 2022113587 32936 0.000000 0.000000 0.000000 1.000000 480.000000 480.000000 0.000000 -1 -1
2022113587 32936 0.000000 0.000000 0.000000 1.000000 480.000000 480.000000 0.000000 1999831045 4
1999831045 0 4 1 19780 -1 -1 -1 -1 -1 0 -1 -1 0 211710 -1 163767 87020 50535 -1 23 -1 0 -1 63 96 96 120.000008 120.000008 -33.639690 120.000008 120.000008 41.360325 120.000008 120.000008 -33.639690 120.000008 120.000008 41.360325 0 0 0 0 6 2022637883 32936 0.000000 0.000000 0.000000 1.000000 960.000000 240.000000 0.000000 -1 -1
2022637883 32936 0.000000 0.000000 0.000000 1.000000 960.000000 240.000000 0.000000 1999831045 4
1999831045 0 4 1 19780 -1 -1 -1 -1 -1 0 -1 -1 0 211710 -1 163767 87020 50535 -1 23 -1 0 -1 63 96 96 120.000008 120.000008 -33.639690 120.000008 120.000008 41.360325 120.000008 120.000008 -33.639690 120.000008 120.000008 41.360325 0 0 0 0 6 2022637883 32936 0.000000 0.000000 0.000000 1.000000 960.000000 240.000000 0.000000 -1 -1
2022637883 32936 0.000000 0.000000 0.000000 1.000000 960.000000 240.000000 0.000000 1999831045 4
1999831045 0 4 1 19780 -1 -1 -1 -1 -1 0 -1 -1 0 211710 -1 163767 87020 50535 -1 23 -1 0 -1 63 96 96 120.000008 120.000008 -33.639690 120.000008 120.000008 41.360325 120.000008 120.000008 -33.639690 120.000008 120.000008 41.360325 0 0 0 0 6 2022637883 32936 0.000000 0.000000 0.000000 1.000000 960.000000 240.000000 0.000000 -1 -1
2022637883 32936 0.000000 0.000000 0.000000 1.000000 960.000000 240.000000 0.000000 1999831045 4
1999831045 0 1 4 19780 -1 -1 -1 -1 -1 0 -1 -1 0 211710 -1 163767 87020 50535 -1 0 -1 0 -1 63 96 96 117.281158 114.719688 6.512024 125.134491 125.637520 81.547302 117.281158 114.719688 6.512024 125.134491 125.637520 81.547302 0 0 0 0 0 2021130532 32990 0.000000 0.000000 0.000000 1.000000 240.000000 960.000000 0.000000 -1 -1
2021130532 32990 0.000000 0.000000 0.000000 1.000000 240.000000 960.000000 0.000000 1999831045 4
1999831045 0 0 4 19780 -1 -1 -1 -1 -1 0 -1 -1 0 211710 -1 163767 87020 50535 -1 8 -1 0 -1 63 96 96 120.000008 120.000008 -33.639690 120.000008 120.000008 41.360325 120.000008 120.000008 -33.639690 120.000008 120.000008 41.360325 0 0 0 0 6 2021654828 32936 0.000000 0.000000 0.000000 1.000000 0.000000 960.000000 0.000000 -1 -1
2021654828 32936 0.000000 0.000000 0.000000 1.000000 0.000000 960.000000 0.000000 1999831045 4
1999831045 0 1 3 19780 -1 -1 -1 -1 -1 0 -1 -1 0 211710 -1 163767 87020 50535 -1 12 -1 0 -1 63 96 96 120.000008 120.000008 -33.639690 120.000008 120.000008 41.360325 120.000008 120.000008 -33.639690 120.000008 120.000008 41.360325 0 0 0 0 6 2021916976 32936 0.000000 0.000000 0.000000 1.000000 240.000000 720.000000 0.000000 -1 -1
2021916976 32936 0.000000 0.000000 0.000000 1.000000 240.000000 720.000000 0.000000 1999831045 4
1999831045 0 0 3 19780 -1 -1 -1 -1 -1 0 -1 -1 0 211710 -1 163767 87020 50535 -1 13 -1 0 -1 63 96 96 120.000008 120.000008 -33.639690 120.000008 120.000008 41.360325 120.000008 120.000008 -33.639690 120.000008 120.000008 41.360325 0 0 0 0 6 2021982513 32936 0.000000 0.000000 0.000000 1.000000 0.000000 720.000000 0.000000 -1 -1
2021982513 32936 0.000000 0.000000 0.000000 1.000000 0.000000 720.000000 0.000000 1999831045 4
1999831045 0 1 2 19780 -1 -1 -1 -1 -1 0 -1 -1 0 211710 -1 163767 87020 50535 -1 16 -1 0 -1 63 96 96 120.000008 120.000008 -33.639690 120.000008 120.000008 41.360325 120.000008 120.000008 -33.639690 120.000008 120.000008 41.360325 0 0 0 0 6 2022179124 32936 0.000000 0.000000 0.000000 1.000000 240.000000 480.000000 0.000000 -1 -1
2022179124 32936 0.000000 0.000000 0.000000 1.000000 240.000000 480.000000 0.000000 1999831045 4
1999831045 0 3 1 19780 -1 -1 -1 -1 -1 0 60713 172 -1 211710 -1 163767 87020 50535 -1 7 -1 0 -1 63 96 96 118.024284 116.671471 -11.367725 121.975731 124.858238 63.766003 118.024284 116.671471 -11.367725 121.975731 124.858238 63.766003 3140 0 0 0 0 2021589291 174633 0.000000 0.000000 0.000000 1.000000 720.000000 240.000000 0.000000 -1 -1
2021589291 174633 0.000000 0.000000 0.000000 1.000000 720.000000 240.000000 0.000000 1999831045 4
1999831045 0 3 4 19780 -1 -1 -1 -1 -1 0 -1 -1 0 211710 -1 163767 87020 50535 -1 4 -1 0 -1 63 96 96 117.455238 116.414528 -19.801666 123.071587 123.585487 55.198349 117.455238 116.414528 3.579506 123.071587 123.585487 78.579521 4005 0 0 0 0 2021392680 1884 0.000000 0.000000 0.000000 1.000000 720.000000 960.000000 0.000000 -1 -1
2021392680 1884 0.000000 0.000000 0.000000 1.000000 720.000000 960.000000 0.000000 1999831045 4