1999503360 0 51 46 19947 156038 -1 -1 -1 0 -1 -1 0 -1 132856 -1 160591 87030 78368 71150 2 2 0 -1 63 96 96 115.938721 125.257813 43.828789 124.061523 131.665527 57.269234 115.938721 125.257813 43.828789 124.061523 131.665527 57.269234 0 1224 0 0 9 2002124802 33349 0.000000 0.000000 0.000000 1.000000 3060.000000 2760.000000 0.000000 -1 -1
2002124802 33349 0.000000 0.000000 0.000000 1.000000 3060.000000 2760.000000 0.000000 1999503360 2
1999503360 0 43 46 202446 -1 19947 -1 -1 0 -1 -1 0 -1 137975 -1 160591 87030 78368 71150 0 0 0 -1 63 96 96 119.827881 126.401245 36.269424 130.634521 128.511108 40.503021 122.889893 126.401245 36.269424 133.696533 128.511108 40.503021 789 0 155 0 9 2001993728 33347 0.000000 0.000000 0.000000 1.000000 2580.000000 2760.000000 0.000000 -1 -1
2001993728 33347 0.000000 0.000000 0.000000 1.000000 2580.000000 2760.000000 0.000000 1999503360 2
1999503360 0 47 42 19947 -1 -1 -1 -1 0 -1 -1 0 -1 132856 -1 160591 87030 78368 71150 54 54 0 23 63 96 96 120.019287 126.457520 27.891876 128.838867 133.274170 41.332329 120.019287 126.457520 26.408272 128.838867 133.274170 42.815933 2362 0 0 0 9 2005532726 33342 0.000000 0.000000 0.000000 1.000000 2820.000000 2520.000000 0.000000 -1 -1
2005532726 33342 0.000000 0.000000 0.000000 1.000000 2820.000000 2520.000000 0.000000 1999503360 2
1999503360 0 51 42 19947 -1 -1 -1 -1 0 -1 -1 0 -1 132856 -1 160591 87030 78368 71150 60 60 0 -1 63 96 96 112.135986 122.788452 19.604088 127.864258 122.788452 35.979576 112.135986 122.788452 19.604088 127.864258 122.788452 35.979576 207 0 0 0 9 2005925948 33343 0.000000 0.000000 0.000000 1.000000 3060.000000 2520.000000 0.000000 -1 -1
2005925948 33343 0.000000 0.000000 0.000000 1.000000 3060.000000 2520.000000 0.000000 1999503360 2
1999503360 0 51 38 -1 -1 -1 -1 -1 -1 -1 -1 -1 -1 132856 -1 160591 87030 50549 71150 137 137 0 -1 63 96 96 119.999756 120.000793 -6.470332 120.000488 120.000793 6.970119 119.999756 120.000793 -6.470333 120.000488 120.000793 6.970120 0 0 0 0 1 2010972297 33338 0.000000 0.000000 0.000000 1.000000 3060.000000 2280.000000 0.000000 -1 -1
2010972297 33338 0.000000 0.000000 0.000000 1.000000 3060.000000 2280.000000 0.000000 1999503360 0
1999503360 0 47 46 19947 156038 202446 -1 -1 0 -1 -1 0 -1 132856 -1 160591 87030 78368 71150 1 1 0 -1 63 96 96 118.384277 119.131592 43.571331 134.230713 131.581055 43.571331 113.464981 119.131592 43.571331 139.150009 131.581055 43.571331 2111 881 493 0 9 2002059265 33348 0.000000 0.000000 0.000000 1.000000 2820.000000 2760.000000 0.000000 -1 -1
2002059265 33348 0.000000 0.000000 0.000000 1.000000 2820.000000 2760.000000 0.000000 1999503360 2
1999503360 0 47 38 19954 -1 -1 -1 -1 0 -1 -1 0 -1 141670 -1 162552 87030 63337 71150 76 76 0 -1 63 96 96 111.859375 125.371460 15.531509 128.907715 132.945435 32.496948 111.859375 125.371460 15.531509 128.907715 132.945435 32.496948 1081 0 0 0 1 2006974540 33337 0.000000 0.000000 0.000000 1.000000 2820.000000 2280.000000 0.000000 -1 -1
2006974540 33337 0.000000 0.000000 0.000000 1.000000 2820.000000 2280.000000 0.000000 1999503360 0
1999503360 0 43 42 19947 -1 -1 -1 -1 0 -1 -1 0 -1 132856 -1 160591 87030 78368 71150 55 55 0 -1 63 96 96 120.920288 118.929260 20.208996 125.859497 128.592224 36.578388 120.920288 118.929260 20.208996 125.859497 128.592224 36.578388 208 0 0 0 9 2005598263 1904 0.000000 0.000000 0.000000 1.000000 2580.000000 2520.000000 0.000000 -1 -1
2005598263 1904 0.000000 0.000000 0.000000 1.000000 2580.000000 2520.000000 0.000000 1999503360 2
1999503360 0 51 50 -1 -1 -1 -1 -1 -1 -1 -1 -1 -1 132856 -1 160591 87030 50549 71150 160 160 0 -1 63 96 96 116.472412 113.248413 50.138405 123.527832 126.751831 49.638618 116.472412 113.248413 50.138405 123.527832 126.751831 49.638618 0 0 0 0 9 2012479648 33357 0.000000 0.000000 0.000000 1.000000 3060.000000 3000.000000 0.000000 -1 -1
2012479648 33357 0.000000 0.000000 0.000000 1.000000 3060.000000 3000.000000 0.000000 1999503360 2
1999503360 0 47 50 19947 156038 -1 -1 -1 0 -1 -1 0 -1 132856 -1 160591 87030 78368 71150 4 4 0 -1 63 96 96 122.707153 112.879517 49.039959 122.707153 127.120728 48.540173 122.707153 112.879517 49.039959 122.707153 127.120728 48.540173 0 0 0 0 9 2002255876 33356 0.000000 0.000000 0.000000 1.000000 2820.000000 3000.000000 0.000000 -1 -1
2002255876 33356 0.000000 0.000000 0.000000 1.000000 2820.000000 3000.000000 0.000000 1999503360 2
1999503360 0 43 50 19947 -1 -1 -1 -1 0 -1 -1 0 -1 132856 -1 160591 87030 78368 71150 3 3 0 -1 63 96 96 123.414429 113.539551 30.101204 124.309448 126.460693 31.396648 123.414429 113.539551 29.593899 124.309448 126.460693 31.903954 0 0 0 0 9 2002190339 33355 0.000000 0.000000 0.000000 1.000000 2580.000000 3000.000000 0.000000 -1 -1
2002190339 33355 0.000000 0.000000 0.000000 1.000000 2580.000000 3000.000000 0.000000 1999503360 2
1999503360 0 47 38 19954 -1 -1 -1 -1 0 -1 -1 0 -1 141670 -1 162552 87030 63337 71150 76 76 0 -1 63 96 96 111.859375 125.371460 15.531509 128.907715 132.945435 32.496948 111.859375 125.371460 15.531509 128.907715 132.945435 32.496948 1081 0 0 0 1 2006974540 33337 0.000000 0.000000 0.000000 1.000000 2820.000000 2280.000000 0.000000 -1 -1
2006974540 33337 0.000000 0.000000 0.000000 1.000000 2820.000000 2280.000000 0.000000 1999503360 0
1999503360 0 47 38 19954 -1 -1 -1 -1 0 -1 -1 0 -1 141670 -1 162552 87030 63337 71150 76 76 0 -1 63 96 96 111.859375 125.371460 15.531509 128.907715 132.945435 32.496948 111.859375 125.371460 15.531509 128.907715 132.945435 32.496948 1081 0 0 0 1 2006974540 33337 0.000000 0.000000 0.000000 1.000000 2820.000000 2280.000000 0.000000 -1 -1
2006974540 33337 0.000000 0.000000 0.000000 1.000000 2820.000000 2280.000000 0.000000 1999503360 0
1999503360 0 43 42 19947 -1 -1 -1 -1 0 -1 -1 0 -1 132856 -1 160591 87030 78368 71150 55 55 0 -1 63 96 96 120.920288 118.929260 20.208996 125.859497 128.592224 36.578388 120.920288 118.929260 20.208996 125.859497 128.592224 36.578388 208 0 0 0 9 2005598263 1904 0.000000 0.000000 0.000000 1.000000 2580.000000 2520.000000 0.000000 -1 -1
2005598263 1904 0.000000 0.000000 0.000000 1.000000 2580.000000 2520.000000 0.000000 1999503360 2
1999503360 27 39 46 91324 -1 -1 -1 -1 -1 -1 80730 -1 -1 137975 -1 160591 87030 50549 71150 138 138 0 -1 63 96 96 117.392395 114.817245 13.621546 135.777771 125.182816 29.990938 136.798538 114.817245 13.621546 155.183914 125.182816 29.990938 1969 0 0 0 1 2011037834 90279 0.000000 0.000000 0.000000 1.000000 2340.000000 2760.000000 27.000000 -1 -1
2011037834 90279 0.000000 0.000000 0.000000 1.000000 2340.000000 2760.000000 27.000000 1999503360 0
1999503360 0 47 38 19954 -1 -1 -1 -1 0 -1 -1 0 -1 141670 -1 162552 87030 63337 71150 76 76 0 -1 63 96 96 111.859375 125.371460 15.531509 128.907715 132.945435 32.496948 111.859375 125.371460 15.531509 128.907715 132.945435 32.496948 1081 0 0 0 1 2006974540 33337 0.000000 0.000000 0.000000 1.000000 2820.000000 2280.000000 0.000000 -1 -1
2006974540 33337 0.000000 0.000000 0.000000 1.000000 2820.000000 2280.000000 0.000000 1999503360 0
1999503360 0 47 38 19954 -1 -1 -1 -1 0 -1 -1 0 -1 141670 -1 162552 87030 63337 71150 76 76 0 -1 63 96 96 111.859375 125.371460 15.531509 128.907715 132.945435 32.496948 111.859375 125.371460 15.531509 128.907715 132.945435 32.496948 1081 0 0 0 1 2006974540 33337 0.000000 0.000000 0.000000 1.000000 2820.000000 2280.000000 0.000000 -1 -1
2006974540 33337 0.000000 0.000000 0.000000 1.000000 2820.000000 2280.000000 0.000000 1999503360 0
1999503360 0 47 38 19954 -1 -1 -1 -1 0 -1 -1 0 -1 141670 -1 162552 87030 63337 71150 76 76 0 -1 63 96 96 111.859375 125.371460 15.531509 128.907715 132.945435 32.496948 111.859375 125.371460 15.531509 128.907715 132.945435 32.496948 1081 0 0 0 1 2006974540 33337 0.000000 0.000000 0.000000 1.000000 2820.000000 2280.000000 0.000000 -1 -1
2006974540 33337 0.000000 0.000000 0.000000 1.000000 2820.000000 2280.000000 0.000000 1999503360 0
1999503360 0 47 38 19954 -1 -1 -1 -1 0 -1 -1 0 -1 141670 -1 162552 87030 63337 71150 76 76 0 -1 63 96 96 111.859375 125.371460 15.531509 128.907715 132.945435 32.496948 111.859375 125.371460 15.531509 128.907715 132.945435 32.496948 1081 0 0 0 1 2006974540 33337 0.000000 0.000000 0.000000 1.000000 2820.000000 2280.000000 0.000000 -1 -1
2006974540 33337 0.000000 0.000000 0.000000 1.000000 2820.000000 2280.000000 0.000000 1999503360 0
1999503360 0 51 46 19947 156038 -1 -1 -1 0 -1 -1 0 -1 132856 -1 160591 87030 78368 71150 2 2 0 -1 63 96 96 115.938721 125.257813 43.828789 124.061523 131.665527 57.269234 115.938721 125.257813 43.828789 124.061523 131.665527 57.269234 0 1224 0 0 9 2002124802 33349 0.000000 0.000000 0.000000 1.000000 3060.000000 2760.000000 0.000000 -1 -1
2002124802 33349 0.000000 0.000000 0.000000 1.000000 3060.000000 2760.000000 0.000000 1999503360 2
1999503360 0 51 42 19947 -1 -1 -1 -1 0 -1 -1 0 -1 132856 -1 160591 87030 78368 71150 60 60 0 -1 63 96 96 112.135986 122.788452 19.604088 127.864258 122.788452 35.979576 112.135986 122.788452 19.604088 127.864258 122.788452 35.979576 207 0 0 0 9 2005925948 33343 0.000000 0.000000 0.000000 1.000000 3060.000000 2520.000000 0.000000 -1 -1
2005925948 33343 0.000000 0.000000 0.000000 1.000000 3060.000000 2520.000000 0.000000 1999503360 2